
SSSSSS000F0SSSSS
SSSSSS000FSSSSSS
SSSSSS000FSSSSSS
SSSSS0000FSSSSSS
SSS000000FESSSSS
SSS00000LF0SSSSS
0000000SSS0ESSS0
00000LSSSS00ES00
0000FSSS0SSL0000
0000FESS0ESS0000
0000F00000ES0000
0L0PF00000000000
SSSSF000000000L0
SSSSS0000FL000SS
SSSSSSLF0FSSSSSS
SSSSSSSF0FSSSSSS

S0000000F000000S
S0000000F000000S
S00000000000000S
S0000000S000000S
S0000L000000000S
S00SSSS00000000S
0000000F00000000
0000000F00000000
L000000F0000P00L
SSS0000000SSSS0S
S00000000000000S
S000L00SS000000S
S00SS0000000000S
S00000000000000S
S00000SSFSS0000S
S0000000F000000S

SSSSSS000F0SSSSS
SSSSSS000F0SSSSS
SSSSSS000F0SSSSS
SSSSS0000F0SSSSS
SSS000000F00ESSS
SSS0F0LP0F0L0ESS
0000FSSSSSSS0000
0000F00000000000
0000F00000000000
0000F00000000000
0SSSSLF000000000
LSSSSSF000000000
SSSSSSF00000000L
SSSSSSFLF0FL00SS
SSSSSSSSF0FSSSSS
SSSSSSSSF0FSSSSS

SSSSSS000F0SSSSS
SSSSSS000F0SSSSS
SSSSSS000F0SSSSS
SSSSS0000F0SSSSS
SSS000000F00ESSS
SSS000L00F0L0ESS
000000SSSSSS0000
00000SSSSSSS0000
0000SSSSSSSSS0F0
0F0SSSS0000ESSF0
0FSSSS000000SSF0
LFSSSS000000ESF0
SSSSSS00000000FL
SSSSSSL0F0P000SS
SSSSSSSSFSSSSSSS
SSSSSSS0F0SSSSSS
