
SS00000FFF0000SS
SS00000FFF0000SS
SS00000FFFL000SS
SS0000L00SS000SS
SS000SS0000000SS
SSSL00000F00LSSS
00SS00SSSFS0SS00
000S0000SFS0S000
00000000SFS00000
000000P00F000000
00LSSSS00F00SL00
0SSS000F0FL0SSS0
SSSS00LFSSS0SSSS
SSS00SSF0000SSSS
SSS0000F0000SSSS
SS00000F00000SSS

9999999999999999
9999999999999999
9999999999999999
9999999999999999
9999999999999999
9999999999999999
9999999999999999
9999999999999999
9999999999999999
9999999999999999
9999999999999999
9999999999999999
9999999999999999
9999999999999999
9999999999999999
9999999999999999

SSSSSSSF0FSSSSSS
SSSSSSSF0FSSSSSS
SSSSSSSF0F0SSSSS
SSSSSS0F0F00SSSS
SSSSSS0F0F0LSSSS
SSSSSS0F0FSSS0SS
SSSS0A0FLSSSSS00
0000000SSS000000
0000S0000F000000
L00000000FSSS000
SS00L0P00FSSSLSS
SSSSSSSSSFSSSSSS
SSSSSSS00F00000S
SSSSSSS00F00SSSS
SSSSSSS00FLSSSSS
SSSSSSS00FSSSSSS

9999999999999999
9999999999999999
9999999999999999
9999999999999999
9999999999999999
9999999999999999
9999959999999999
9999999999999999
9999999999999999
9999999999999999
9999999999999999
9999999999999999
9999999999999999
9999999999999999
9999999999999999
9999999999999999
