
SSSSSSSSSSSSSSSS
SSSSSSSSSSSSSSSS
SSSSSSSSSSSSSSSS
SSSSSSSSSSSSSSSS
SSSS0000A0000SSS
SS0000000000000S
S000000000000000
0000000000000000
0000000000000000
L000000000000000
S00000000000000L
SSSSSLK00000LSSS
SSSSSSS00P00SSSS
SSSSSSSSSSSSSSSS
SSSSSSSSSSSSSSSS
SSSSSSSSSSSSSSSS

9999999999999999
9999999999999999
9999999999999999
9999999999999999
9999999939999999
9999999999999999
9999999999999999
9999999999999999
9999999999999999
9999999999999999
9999999999999999
9999999999999999
9999999999999999
9999999999999999
9999999999999999
9999999999999999

SSSSSSSSSSSSSSSS
SSSSSSSSSSSSSSSS
SSSSSSSSSSSSSSSS
SSSSSSSSSSSSSSSS
SSSS0000A0000SS0
SS00000000000000
S000000000000000
0000000000000000
0000000000K00000
0000000PLSSS0000
000000SSSSSS0000
00LSSSSSSSSSSSL0
0SSSSSSSSSSSSSSS
SSSSSSSSSSSSSSSS
SSSSSSSSSSSSSSSS
SSSSSSSSSSSSSSSS

9999999999999999
9999999999999999
9999999999999999
9999999999999999
9999999969999999
9999999999999999
9999999999999999
9999999999999999
9999999999999999
9999999999999999
9999999999999999
9999999999999999
9999999999999999
9999999999999999
9999999999999999
9999999999999999

SSSSSSSSSSSSSSSS
SSSSSSSSSSSSSSSS
SSSSSSSSSSSSSSSS
SSSSSSSSSSSSSSSS
00000000000A0000
0000000000000000
0F0000L000000L00
0FSSSSSSSSSSSSS0
0FSSSSSS00SSSSS0
0F00SSS0000SSS00
0F00000000000000
0FL00000K0P00L00
SSSSSSSSSSSSSSSS
SSSSSSSSSSSSSSSS
SSSSSSSSSSSSSSSS
SSSSSSSSSSSSSSSS

9999999999999999
9999999999999999
9999999999999999
9999999999999999
9999999999969999
9999999999999999
9999999999799999
9999999922999999
9999999999999999
9999999999999999
9999999999999999
9999999999999999
9999999999999999
9999999999999999
9999999999999999
9999999999999999

SSSSSSSSSSSSSSSS
SSSSSSSSSSSSSSSS
SSSSSSSSSSSSSSSS
SSSSSSSSSSSSSSSS
0000000000000000
0000000000000000
0000000F00A00000
00SSSSSFSSSSSS00
00SSSSSFSSSSSS00
0000000F00000000
0000000F00000000
00L0000F0K0P0L00
SSSSSSSSSSSSSSSS
SSSSSSSSSSSSSSSS
SSSSSSSSSSSSSSSS
SSSSSSSSSSSSSSSS

9999999999999999
9999999999999999
9999999999999999
9999999999999999
9999999999999999
9999999999999999
9999999999799999
9999999999999999
9999999999999999
9999999999999999
9999999999999999
9999999999999999
9999999999999999
9999999999999999
9999999999999999
9999999999999999
