
SSSSSSSF0FSSSSSS
SSSSSSSF0FSSSSSS
SSSSSSSF0F0SSSSS
SSSSSS0F0F00SSSS
SSSSSS0F0F0LSSSS
SSSSSS0F0FSS0A0S
SSSS000FSSSS0000
0000000F00000000
0000S00F00000000
L000000F00SSS000
SS00L0PF0SSSSLSS
SSSSSSSSSSSSSSSS
SSSSSSSSSSSSSSSS
SSSSSSSSSSSSSSSS
SSSSSSSSSSSSSSSS
SSSSSSSSSSSSSSSS

9999999999999999
9999999999999999
9999999999999999
9999999999999999
9999999999999999
9999999999999699
9999999999999999
9999999999999999
9999999999999999
9999999999999999
9999999999999999
9999999999999999
9999999999999999
9999999999999999
9999999999999999
9999999999999999

SS00000FFF0000SS
SS00000FFF0000SS
SS00000FFFL000SS
SS0000L00SS000SS
SSA00SS000000ASS
SSSL0000000FLSSS
00SS00SSSSSFSS00
000S0000SSSFS000
00000000SSSF0000
000000P0000F0000
00LSSSS0000FSL00
0SSSSSSSSSSFSSS0
SSSSSSSSSSSSSSSS
SSSSSSSSSSSSSSSS
SSSSSSSSSSSSSSSS
SSSSSSSSSSSSSSSS

9999999999999999
9999999999999999
9999999999999999
9999999999999999
9959999999999599
9999999999999999
9999999999999999
9999999999999999
9999999999999999
9999999999999999
9999999999999999
9999999999999999
9999999999999999
9999999999999999
9999999999999999
9999999999999999
