
SSSSSSSSSSSSSSSS
SSSSSSSSSSSSSSSS
SSSSSSSSSSSSSSSS
SSSSS00000SSSSSS
SSS00000000SSSSS
SS0000000000SSSS
SS0000000000SSSS
SS00000000000SSS
SS000000000000SS
SS0000L0ALF0000S
SS0000SSSSF00F0S
SS0000SSSSF00FSS
SSS0000000F00F00
SSSSL00000FLSF00
SSSSSS0FF0SSSF00
SSSSSSSFFSS00F00

9999999999999999
9999999999999999
9999999999999999
9999999999999999
9999999999999999
9999999999999999
9999999999999999
9999999999999999
9999999999999999
9999999949999999
9999999999999999
9999999999999999
9999999999999999
9999999999999999
9999999999999999
9999999999999999

SSSSSSSSSSSSSSSS
SSSSSSSSSSSSSSSS
SSSSS00A00ASSSSS
SSS0A00000000SSS
SSS000000000A0SS
SSA00000000000A0
SS00000000000000
SS00000000000000
SS00000000000000
SS00000000F0000L
SS00000000F0000S
SS00000000F00SSS
SSS0000000F00SSS
SSSSL00000FLSSSS
SSSSSS0FF0SSSSSS
SSSSSSSFFSSSSSSS

9999999999999999
9999999999999999
9999999139139999
9999199999339999
9939999999931999
9919999999993919
9399999999993999
9999999999999399
9399999999999939
9999999949999939
9399999999999999
9399999999999999
9939999999999999
9999999999999999
9999999999999999
9999999999999999

S000S00FF00S000S
S000SSLFFLSS000S
S000SSSFFSSS000S
S000SSSFFSSS000S
S000SSSFFSSS000S
S000SSSFFSSS000S
S0A0000FF0000A0S
S0S000LFFL000S0S
S0S000S00S000S0S
S0S0A000000A0S0S
S0SSS000000SSS0S
S00000000000000S
SL000000000000LS
SSSSSSSSSSSSSSSS
SSSSSSSSSSSSSSSS
SSSSSSSSSSSSSSSS

9999999999999999
9999999999999999
9999999999999999
9999999999999999
9999999999999999
9999999999999999
9959999999999599
9999999999999999
9999999999999999
9999599999959999
9999999999999999
9999999999999999
9999999999999999
9999999999999999
9999999999999999
9999999999999999

SSSSSSSSSSSSSSSS
SS0SSA0000A0S0SS
S000SSSFFSSSS0SS
S000SSSFFSSSS0SS
S000SSSFFSSSS0SS
S000SSSFFSSSS00S
S0A0000FF0000A0S
S0S000LFFL000S0S
S0S000S00S000S0S
S0S0000000000S0S
S0S0000000000S0S
S00000000000000S
SL000000F00000LS
SSSSSSSSFSSSSSSS
SSSSSS00F00SSSSS
SSSSSS00F00SSSSS

9999999999999999
9999966999699999
9999999999999999
9999999999999999
9999999999999999
9999999999999999
9969999999999699
9999999999999999
9999999999999999
9999599999959999
9999999999999999
9999999999999999
9999999999999999
9999999999999999
9999999999999999
9999999999999999

SSSSSSSSSSSSSSSS
SSSSSSSSSSSSSSSS
SSSSSSSSSSSSSSSS
SSSSSSSSSSSSSSSS
SSSSSSSSSSSSSSSS
SSSSSSSSSSSSSSSS
SSSSSSSSSSSSSSSS
SSSSSSSSSSSSSSSS
SSSSSSSSSSSSSSSS
SSSSSSSSSSSSSSSS
SSSSSSSSSSSSSSSS
SSSSSSSSSSSSSSSS
SSSSSSSSSSSSSSSS
SSSSSSSSSSSSSSSS
SSSSSSSSSSSSSSSS
SSSSSSSSSSSSSSSS

9999999999999999
9999999999999999
9999999999999999
9999999999999999
9999999999999999
9999999999999999
9999999999999999
9999999999999999
9999999999999999
9999999999999999
9999999999999999
9999999999999999
9999999999999999
9999999999999999
9999999999999999
9999999999999999

SSSSSSSSSSSSSSSS
SSSSSSSSSSSSSSSS
SSSSSSSSSSSSSSSS
SSSSSSSSSSSSSSSS
SSSSSSSSSSSSSSSS
SSSSSSSSSSSSSSSS
SSSSSSSSSSSSSSSS
SSSSSSSSSSSSSSSS
SSSSSSSSSSSSSSSS
SSSSSSSSSSSSSSSS
SSSSSSSSSSSSSSSS
SSSSSSSSSSSSSSSS
SSSSSSSSSSSSSSSS
SSSSSSSSSSSSSSSS
SSSSSSSSSSSSSSSS
SSSSSSSSSSSSSSSS

9999999999999999
9999999999999999
9999999999999999
9999999999999999
9999999999999999
9999999999999999
9999999999999999
9999999999999999
9999999999999999
9999999999999999
9999999999999999
9999999999999999
9999999999999999
9999999999999999
9999999999999999
9999999999999999
