
SSSSSSSSSSSSSSSS
SSSSSSSSSSSSSSSS
SSSSSSSSSSSSSSSS
SSSSSSSSSSSSSSSS
SSSSSSSSSSSSSSSS
SSSSSSSSSSSSSSSS
SSSSSSSSSSSSSSSS
SSSSSSSSSSSSSSSS
SSSSSSSSSSSSSSSS
SSSSSSSSSSSSSSSS
SSSSSSSSSSSSSSSS
SSSSSSSSSSSSSSSS
SSSSSSSSSSSSSSSS
SSSSSSSSSSSSSSSS
SSSSSSSSSSSSSSSS
SSSSSSSSSSSSSSSS

SSSSSSSSSSSSSSSS
SSSSSSSSSSSSSSSS
SSA00SS0SSA00SSS
QS00CDSSQS00CDSS
QSQ0DSSDQSQ0DSSD
Q0000DFSQ0000DSS
SSSSFSFS0SSSFSSS
SSS0FSF0SSS0FSSS
SSSSSSF0SSSSSSSS
SSSSSSF0SSSSSSSS
SSA00SF0SSA00SSS
QS00CDFSQS00CDSS
QSQ0DSFDQSQ0DSSD
Q0000DFSQ0000DSS
SSSSFS0S0SSSFSSS
SSS0FSSSSSS0FSSS

SSSSFSSSSSSSFSSS
S000FSSSS000FSSS
SSA0F000SSA0F000
QSQ0FDSSQSQ0FDSS
QSQSFDSSQSQSFDSS
Q00ESDSSQ00ESDSS
S00S0SSSS00S0SSS
SSS00SSSSSS00SSS
SSSSFSSSSSSSFSSS
S000FSSSS000FSSS
SSA0F000SSA0F000
QSQ0FDSSQSQ0FDSS
QSQSFDSSQSQSFDSS
Q00ESDSSQ00ESDSS
S00S0SSSS00S0SSS
SSS00SSSSSS00SSS
