
ASS0FSSAASS0FSSA
QES0F00DQES0F00D
0000F0000000F000
0000FSSSS000F000
00FFF00000FFF000
00F0F0000P000000
QXX0FL000L000LXD
WSS0XXXDWSS0FXSD
ASS00S000000FSSA
QES000000000F00D
000000000000F000
000000000000F000
0000000000FFF000
0P000000L0F00000
QXX00LXDQXX00LXD
WSS0FXSDWSS0FXSD

ASS0FSSAASS0FSSA
QES0F00DQES0F00D
0000F00D0000F00D
0000F0000000F000
00L0FFF000L0FFF0
EXD000F0EXD000F0
QSD00PXDQSD000XD
WSSXSXSDWSSXFXSD
ASS00SSAASS0FSSA
QES0000DQES0F00D
0000000D0000F00D
000000000000F000
00L00FF000L0FFF0
EXD000F0EXD000F0
QSD000XDQSD0L0XD
WSSXFXSDWSSXFXSD