
ASS0F00SSSS0FSSE
QES0F000QES00000
0000F00000000000
0000F00000000000
0000F00000000000
0000F0000000F000
QXL0F0XDQXL0F0XD
WSQXX0SDWSQ0FXSD
Q00000000000FSSD
QS0000000000FSSD
0SS000000000FS00
000000000000F000
0SS000000000FS00
000000000000F000
Q000L00P00L0F00D
WXXXXXXXXXXXXXXC