
SSSSSSSSSSSSSSSS
SSSSSSSSSSSSSSSS
SSSSSSSSSSSSSSSS
SSSSSSSSSSSSSSSS
SSSSSSSSSSSSSSSS
SSSSSSSSSSSSSSSS
SSSSSSSSSSSSSSSS
SSSSSSSSSSSSSSSS
SSSSSSSSSSSSSSSS
SSSSSSSSSSSSSSSS
SSSSSSSSSSSSSSSS
SSSSSSSSSSSSSSSS
SSSSSSSSSSSSSSSS
SSSSSSSSSSSSSSSS
SSSSSSSSSSSSSSSS
SSSSSSSSSSSSSSSS

9999999999999999
9999999999999999
9999999999999999
9999999999999999
9999999999999999
9999999999999999
9999999999999999
9999999999999999
9999999999999999
9999999999999999
9999999999999999
9999999999999999
9999999999999999
9999999999999999
9999999999999999
9999999999999999

SSSSSSSSSSSSSSSS
SSSSSSSSSSSSSSSS
SSSSSSSSSSSSSSSS
SSSSSSSSSSSSSSSS
SSSSSSSSSSSSSSSS
0ESSSSSSSSSSSSA0
00SSSSSSSSSSSS00
000000M000000000
0000000000000000
00000000L0000000
00CXXXXXXXXXXW00
LCSSSSSSSSSSSSWL
XSSSSSSSSSSSSSSX
SSSSSSSSSSSSSSSS
SSSSSSSSSSSSSSSS
SSSSSSSSSSSSSSSS

9999999999999999
9999999999999999
9999999999999999
9999999999999999
9999999999999999
9999999999999999
9999999999999999
9999993999999999
9999999999999999
9999999999999999
9999999999999999
9999999999999999
9999999999999999
9999999999999999
9999999999999999
9999999999999999

SSSSSSSSSSSSSSSS
SSSSSSSSSSSSSSSS
SSSSSSSSSSSSSSSS
SSSSSSSSSSSSSSSS
Q0000EA00000ESSS
Q0000000000000ES
Q00000000000000D
Q000000CXXW0000D
Q000000ESSA0000D
Q00000000000000D
Q00L0000000000LD
SXXXXW00000000CS
SSSSSSW00F0L0CSS
SSSSSSSW0FCXXSSS
SSSSSSSSWFESSSSS
SSSSSSSSQF0DSSSS

9999999999999999
9999999999999999
9999999999999999
9999999999999999
9999999999999999
9999999999999999
9999999999999999
9999999333399999
9999999333399999
9999999999999999
9999999999999999
9999999999999999
9999999999999999
9999999999999999
9999999999999999
9999999999999999

SSSSSSQ00FSSSSSS
SSSSSSQ00FSSSSSS
SSSSSSQ00FSSSSSS
SSSSSSA0LF00DSSS
Q0000S00CFW0ESSS
Q000000CSSQ000ES
Q00000CSSSQ0000D
Q00000DSSSQ0000D
Q00000DSSSQ0000D
Q00000ESSSQ0000D
Q00L000ESSA000LD
SXXXXW00000000CS
SSSSSSW00F000CSS
SSSSSSSW0FCXXSSS
SSSSSSSSWFESSSSS
SSSSSSSSQF0DSSSS

9999999999999999
9999999999999999
9999999999999999
9999999999992999
9999929999992299
9999999999999999
9999999999999999
9999999999999999
9999999999999999
9999999999999999
9999999999999999
9999999999999999
9999999999999999
9999999999999999
9999999999999999
9999999999999999

SSSSSSSSSSSSSSSS
SSSSSSSSSSSSSSSS
SSSSSSSSSSSSSSSS
SSSSSSSSSSSSSSSS
00000EA00000ESSS
00000000000000ES
0000000000000000
0000000000000000
0000000L00000000
000000XXX0000000
0000M00000000000
XXXXXW00000000CX
SSSSSSW00F000CSS
SSSSSSQ00FCXXSSS
SSSSSSQ00FESSSSS
SSSSSSQ00F0DSSSS

9999999999999999
9999999999999999
9999999999999999
9999999999999999
9999999999999999
9999999999999999
9999999999999999
9999999999999999
9999999999999999
9999999999999999
9999699999999999
9999999999999999
9999999999999999
9999999999999999
9999999999999999
9999999999999999
