
SSSSSQ000F0DSSSS
SSSSSQ000F0SSSSS
SSSSSQ000F0SSSSS
SSSSA0000F0SSSSS
SSQ000000F00ESSS
SSA0F0LP0F0L0ESS
0000FXXXXXXX0000
0000F00000000000
0000F00000000000
0000F00000000000
0CXXWLF000000000
LDSSSWF000000000
XSSSSQF00000000L
SSSSSQFLF0FL00CX
SSSSSSXXF0FXXXSS
SSSSSSSSF0FSSSSS

9999999999999999
9999999999999999
9999999999999999
9999999999999999
9999999999999999
9999999999999999
9999999999999999
9999999999999999
9999999999999999
9999999999999999
9999999999999999
9999999999999999
9999999999999999
9999999999999999
9999999999999999
9999999999999999

SSSSSQ000F0DSSSS
SSSSSQ000FCSSSSS
SSSSSQ000FDSSSSS
SSSSA0000FDSSSSS
SSQ000000FESSSSS
SSA0000MLF0DSSSS
0000000CXW0ESSA0
00000LCSSQ00EA00
0000FCSQ0DWL0000
0000FESA0ESW0000
0000F00000EA0000
0L0PF00000000000
XXXWF000000000L0
SSSSW0000FL000CX
SSSSSWLF0FCXXXSS
SSSSSSWF0FDSSSSS

9999999999999999
9999999999999999
9999999999999999
9999999999999999
9999999999999999
9999999599999999
9999999999999999
9999999999999999
9999999999999999
9999999999999999
9999999999999999
9999999999999999
9999999999999999
9999999999999999
9999999999999999
9999999999999999

SSSSSQ000F0DSSSS
SSSSSQ000F0SSSSS
SSSSSQ000F0SSSSS
SSSSA0000F0SSSSS
SSQ000000F00ESSS
SSA000L00F0L0ESS
000000CXXXXW0000
00000CSSSSSQ0000
0000CSSSSSSSW0F0
0F0CSSA0000ESWF0
0FCSSQ000000SQF0
LFDSSQ000000EAF0
XXSSSQ00000000FL
SSSSSQL0F0P0M0CX
SSSSSSXXFXXXXXSS
SSSSSSQ0F0DSSSSS

9999999999999999
9999999999999999
9999999999999999
9999999999999999
9999999999999999
9999999999999999
9999999999999999
9999999999999999
9999999999999999
9999999999999999
9999999999999999
9999999999999999
9999999999999999
9999999999993999
9999999999999999
9999999999999999

Q0000000F000000D
Q0000000F000000D
Q0000000L000000D
Q000000FX000000D
Q0000L0F0000000D
Q00XXXXF0000000D
0000000F00000000
0000000F00000000
L000000XF000P00L
XXX00000F0XXXX0D
Q0000000F000000D
Q000L00XX000000D
Q00XX0000000000D
Q00000000L00000D
Q00000XXFXX0000D
Q0000000F000000D

9999999999999999
9999999999999999
9999999999999999
9999999999999999
9999999999999999
9999999999999999
9999999999999999
9999999999999999
9999999999999999
9999999999999999
9999999999999999
9999999999999999
9999999999999999
9999999999999999
9999999999999999
9999999999999999
