
SSSSSSSSSSSSSSSS
SSSSSSSSSSSSSSSS
SSSSSSSSSSSSSSSS
0000000000000000
0000000000000000
0L0000L00FP00L00
XXXXXXXXXFXXXXXX
SSSSSSSSSFSSSSSS
000000000F000000
000000000F000000
000000000C000000
00000000CSW00000
0000L00CSSSW00L0
XXXXXXXSSSSSXXXX
SSSSSSSSSSSSSSSX
SSSSSSSSSSSSSSSS

9999999999999999
9999999999999999
9999999999999999
9999999999999999
9999999999999999
9999999999999999
9999999999999999
9969666999999999
9999999999999999
9999999999999999
9999999999999999
9999999999999999
9999999999999999
9966999999999999
9999999999999999
9999999999999999

SSSSSSSSSSSSSSSS
SSSSSSSSSSSSSSSS
SSSSSSSSSSSSSSSS
0000000000000000
0000000000000000
0000000LFFL00000
0000CXXXFFXXXW00
0000DSSSFFSSSQ00
0000ESSSFFSSSA00
000000DQFFDQ0000
000000DQFFDQ0000
00000000FF000000
0L000L00FFP0L00L
XXXXXXXXXXXXXXXX
SSSSSSSSSSSSSSSX
SSSSSSSSSSSSSSSS

9999999999999999
9999999999999999
9999999999999999
9999999999999999
9999999999999999
9999999999999999
9999999999999999
9999999999999999
9999999999999999
9999995599559999
9999995599559999
9999999999999999
9999999999999999
9999999999999999
9999999999999999
9999999999999999

SSSSSSSSSSSSSSSS
SSSSSSSSSSSSSSSS
SSSSSSSSSSSSSSSS
0000000000000000
0000000000000000
00000000M0L00000
00000CXXXXW0PLF0
0000CSSSSSSXXWF0
0FLCSSSSSSSSSAF0
0FESA000000000F0
0F000000000000F0
0F000000000000F0
0FL00000L0000LF0
XXXXXXXXXXXXXXXX
SSSSSSSSSSSSSSSS
SSSSSSSSSSSSSSSS

9999999999999999
9999999999999999
9999999999999999
9999999999999999
9999999999999999
9999999949999999
9999999999999999
9999999999999999
9999999999999999
9999999999999999
9999999999999999
9999999999999999
9999999999999999
9999999999999999
9999999999999999
9999999999999999

SSSSSSSSSSSSSSSS
SSSSSSSSSSSSSSSS
SSSSSSSSSSSSSSSS
SSSSSSSSSSSSSSSS
SSSSSSSSSSSSSSSS
0ESSSSSSSSSSSSA0
00SSSSSSSSSSSS00
00000M0000000000
0000000000000000
0000000PL0000000
00CXXXXXXXXXXW00
LCSSSSSSSSSSSSWL
XSSSSSSSSSSSSSSX
SSSSSSSSSSSSSSSS
SSSSSSSSSSSSSSSS
SSSSSSSSSSSSSSSS

9999999999999999
9999999999999999
9999999999999999
9999999999999999
9999999999999999
9999999999999999
9999999999999999
9999939999999999
9999999999999999
9999999999999999
9999229999229999
9999999999999999
9999999999999999
9999999999999999
9999999999999999
9999999999999999
