
A000000F0XXXXXFE
M000000F000000F0
0000000F000LCWF0
0000000F000CSQF0
0000000F00CSSQF0
0F00000F0CSSSQF0
QF00000FCSSSSQF0
QF0000LCSSSSSQF0
QF000CXSSSSSSQF0
QFPLCSSSSSSSSQF0
QFCXSSSSSSSSSQFL
SXSSSSSSSSSSSSXX
SSSSSSSSSSSSSSSS
SSSSSSSSSSSSSSSS
SSSSSSSSSSSSSSSS
SSSSSSSSSSSSSSSS

9999999999999999
2999999999999999
9999999999999999
9999999999999999
9999999999999999
9999999999999999
9999999999999999
9999999999999999
9999999999999999
9999999999999999
9999999999999999
9999999999999999
9999999999999999
9999999999999999
9999999999999999
9999999999999999

SSSSSQ000F0DSSSS
SSSSSQ000F0SSSSS
SSSSSQ000F0SSSSS
SSSSA0000F0SSSSS
SSQM00000F00ESSS
SSA0F0LP0F0L0ESS
0000FXXXXXXX0000
0000F00000000000
0000F00000000000
0000F00000000000
0CXXWLF000000000
LDSSSWF000000000
XSSSSQF00000000L
SSSSSQF000L000CX
SSSSSSXXXXXXXXSS
SSSSSSSSSSSSSSSS

9999999999999999
9999999999999999
9999999999999999
9999999999999999
9996999999999999
9999999999999999
9999999999999999
9999999999999999
9999999999999999
9999999999999999
9999999999999999
9999999999999999
9999999999999999
9999999999999999
9999999999999999
9999999999999999

SSSSSQ000F0DSSSS
SSSSSQ000F0SSSSS
SSSSSQ000F0SSSSS
SSSSA0000F0SSSSS
SSQ000000F00ESSS
SSA000L00F0L0ESS
000000CXXXXW0000
00000CSSSSSQ0000
0000CSSSSSSSW0F0
0F0CSSA0000ESWF0
0FCSSQ000000SQF0
LFDSSQ000000EAF0
XXSSSQ00000000FL
SSSSSQL0P0L000CX
SSSSSSXXXXXXXXSS
SSSSSSSSSSSSSSSS

9999999999999999
9999999999999999
9999999999999999
9999999999999999
9999999999999999
9999999999999999
9999999559999999
9999999999999999
9999999999999999
9999999999919999
9999999999991199
9999999999991199
9999999999999999
9999999999999999
9999999999999999
9999999999999999
